_fragments,IEEE 802.15.4,6LoWPAN,CoAP,Content,_sum
3,63,23,0,206,292
2,42,18,0,144,204
3,63,23,0,279,365
2,42,18,0,144,204
1,21,9,0,46,76
1,21,9,0,51,81
2,42,18,0,134,194
2,42,18,0,108,168
1,21,9,0,66,96
2,42,18,0,134,194
2,42,18,0,108,168
1,21,9,0,66,96
1,21,9,0,72,102
